NO ./scenes/textures/eagle.xpm42
SO ./scenes/textures/greystone.xpm42
WE ./scenes/textures/purplestone.xpm42
EA ./scenes/textures/redstone.xpm42

F 32,16,16
C 64,64,128

1111111111111111111111111111111111111111111111111111111111111111
1000010001000010000000100000000010000100001000000010000100000001
10000D00010000D00000001000000000D0000D00001000000010000100000001
100001000D0000100000001000111000100001000010000000D0000000000001
1000011111111110000000000011100010000100001000000010000100000001
1000011111000010000000100011100010000111111000000010000100000001
10000100010000100000001000000000D000000000110101111111D100000001
1000010001000010000000100000000010000000001100011100000100000001
10000100010000100000001111111111100000000011D1011100000111101111
1111111D11111D11111Dd1100001000011111111111101011100000100000001
1000010000100000010000100001000010000000001101011111000100000001
1000010000100000010000100000000010000000001101d1   1000100000001
100000000000000000000010000100001000000000110001   1111100000001
10000100001000000100001000010000100000000011010111111111111d1111
1000010000100000010000111D111111110001111D1000001000001000000001
1111111111111d1111100110000100000100010000100000D000001000000001
1111111111100000100000100000000001000101101000001000001000000001
1000100000100000100000100001001001000100001111111000001000000001
1000100000111100000000100001001111000111111111111000111000000001
1000D00000111100100000100001001001000110000000000000000000000001
1000100000000000100000100000000001000110000000000000000000000001
1000100000000000100000100001000001000110000000000000000000000001
1111111111110001101111101111111111000111Dd1111111111111111111111
100001000001000110110000111111111000001000000010000D000001000001
10000100000D0001101101111111000110000000000000100001000001000001
10000100000100011011000110000W0110000000000000d00001000001000001
100001D111110001100111011011000110000000000000100001000001000001
10000000000100011101110110111D111000000000000010000100000d000001
10000000000100011100000D0001000110000010000000111111111D11111111
10000000000110111111111100010001111D1111111d111      10000000001
11D11111011100011000001100010001100000001000001      10000000001
10001000000100011001001100010001100000001000001      10000000001
10001000000100011001001100010001100000001000001      10000000001
1000d000000100000001000000010000000000001000001      111d111D111
1000100000011011111111111111111110000000100000111111110000000001
1000100000010000001100000100000010000000100000100000010000000001
11111111D11100000011000001000000D0000000100000100000000000000001
      1000010000001100000100000010000000100000100000010000000001
      10000111Dd1111000001111111111111111111D1111111111111111111
      1000010000001100000100000010000000001000001111111000011111
      10000100000011000001000000D000000000000000000D000000011111
      1111110000001100000100000010000000001000001111111000011111
111111111110000000011101111111111000000000111D111     1000000001
1000000001100011000111011111111111111111D11000001     1000000001
1000100001100011000111011110000010000110001000001     1000000001
10001000011000110001110111100000D0000110001000001111111111111Dd1
1000100001100011000110001110000010000110001000001000010000000001
1000100000000011000000100000000011101111111000000000010000000001
11D11111111111111111100011100000100000100000000000000D0000000001
10000000011111000001110111100000D00000D0000000000000010000000001
1000000001000100000111011110000010000010000000001000010001110001
100000000d000100000111011111111110000011111111111111D10001110001
1000000001000100000100000001000011111110000100001000010001110001
100000000111110000010000000100001     10000100001000010000000001
100000000100010000000000000000001     10000100001000010000000001
100000000D00010000010000000100001     10000100001000010000000001
100000000100010000010000000100001     10000D0000D000010000000001
1111111111111111111111111111111111111111111111111111111111111111