NO ./scenes/textures/eagle.xpm42
SO ./scenes/textures/greystone.xpm42
WE ./scenes/textures/purplestone.xpm42
EA ./scenes/textures/redstone.xpm42

F 124,96,124
C 0,32,32

111111111111111111111111111111111111111111111111111
100000100010000000000000000000101010100010001000001
101011111010101111111110111011101010101110111110111
101000001000101000100010001010101000101000001010001
101111101011111010101111111010101010101111101011101
101000000000001010000000101000101010100010000000001
111110111111111010101010101110101011101010111111111
100000001010100010101010001000100010001000000010001
101011111010101011111110101000000000000011111111101
101000001000101010001010100010000010001000000000001
101110101011111110111011111000000001101110111011101
101000100010101000100000100010101010000010001000101
111010111110101011111011111110101010111111111110111
100010000000100010000000000000001000001010100010001
111111111010111010111010101110101010101010111010111
101010000010000010001010101000101010100000100000101
101010101110101111101111111111111110101110101111101
100000101010100000101010000010000010101000100000001
101111111011111111111011101111111011111111101010101
100010001010100000000010000010100010100000001010101
111111101010101011111110111010101010101011111111111
101000000000001010000010001000101000001000000000001
101010101000000010101110111011101111101110111111101
101010101000000010101010001010001000101000100010001
101111101110111011101010101010111110101110101110111
1000100010000010100010001N1000000000101000000010001
111010101111101010000000111011101011111111111011111
100000100010001000000010001000101000100000100000001
111011111110000000000011111111111011111010101011111
101000001010000000000000000010101010101010101000001
101011111010111000000111111010101010101011101111111
101000101000100000100010001000000000000010000000001
101110101011101011101110101111101110101111111111101
101010100010001000100000101000001000101000100000101
101010101110111111111011111110101110111110111010101
100010100010000000000000100010101000100000100010001
111010111010101110111010101010101111101011101111101
101010100010101010001010101000100000101010101000001
101011101111101011111011111011111011101010101111101
100000100010001010001010101000100010101000001010001
101111111111101011101010101011111010111111101011101
100010100000000010000000100010001000101010100000101
101010101110101011101010111110111011101010111011101
101000001000101010101010101000001000001010101000101
111011111010101010111011101011101110101010101011111
100010100010101000100010000010100010101000001000001
111010111011101010111011111010111110111111101110101
100000001000101010001010100010100000100010001000101
101111101110111110111010101010111010101111101111101
101000000010100000100000001000000010000010000000001
111111111111111111111111111111111111111111111111111
