NO ./scenes/textures/eagle.xpm42
SO ./scenes/textures/greystone.xpm42
WE ./scenes/textures/purplestone.xpm42
EA ./scenes/textures/redstone.xpm42

F 124,96,124
C 0,32,32

111111111111
100010000001
10N0d0001101
100010001 1
1111 1111